#########
#X.X#...#
#...CC.P#
#.......#
#.......#
#########